Nuclear war is on the horizon, two nations are in extremely high tension and anything can set the other one off to fire first.  There are rumors about talks of peace, but it seems unlikely at this point.  Each side is hoping that somehow nuclear war can be prevented to save the millions of lives that it would cause...

Turtle of Wrath
An Interactive Fiction by Alex Ayerdi
Release 1 / Serial number 150422 / Inform 7 build 6L38 (I6/v6.33 lib 6/12N) SD

Desert
You are a turtle, and you find yourself at the south edge of a road in the middle of a desert.  You hear a car coming from the east, and another coming from the west much farther away.

You do not seem too interested in other things around you but you do see a cactus across the road that might offer shade and you see a little grape next to your foot. Type "help" to see a list of possible commands.

>x road
You can't see any such thing.

>help
You are a turtle, so you can really only move, eat, and hide in your shell.  Available commands are going in directions "go north" for example, eating things "eat berry" for example, and "hide."

>go east
You think about going east, but there is nothing of interest that way, so you decided not to move.

>go west
You think about going west, but there is nothing of interest that way, so you decided not to move.

>go south
You think about going south, but there is nothing of interest that way, so you decided not to move.

>go north
road
A long, narrow stretch with a smoothed or paved surface, made for traveling by motor vehicle, carriage, etc., between two or more points; street or highway.  It appears to be the only thing between you and the cactus.  You notice the air above the road appears to wiggle and wave.

>go east
You think about going east, but there is nothing of interest that way, so you decided not to move.

* * *

>go north
CRUNCH!  You got ran over by a Jalopy carrying a ton of stuff on its hood.  Weird...  Well, you should have trusted your instincts and taken time to have a bite to eat.

    *** The End ***

Would you like to RESTART, RESTORE a saved game, QUIT or UNDO the last command?

>restart
Nuclear war is on the horizon, two nations are in extremely high tension and anything can set the other one off to fire first.  There are rumors about talks of peace, but it seems unlikely at this point.  Each side is hoping that somehow nuclear war can be prevented to save the millions of lives that it would cause...

Turtle of Wrath
An Interactive Fiction by Alex Ayerdi
Release 1 / Serial number 150421 / Inform 7 build 6L38 (I6/v6.33 lib 6/12N) SD

Desert
You are a turtle, and you find yourself at the south edge of a road in the middle of a desert.  You hear a car coming from the east, and another coming from the west much farther away.

You do not seem too interested in other things around you but you do see a cactus across the road that might offer shade and you see a little grape next to your foot. Type "help" to see a list of possible commands.

>eat berry
You can't see any such thing.

>eat grape
You reach down with your turtle mouth and eat the grape.  Yum!  You watch innocently as a Jalopy packed full of people and random stuff on its hood drives by at turtle-crunching speed.

>go north
Road
A long, narrow stretch with a smoothed or paved surface, made for traveling by motor vehicle, carriage, etc., between two or more points; street or highway.  It appears to be the only thing between you and the cactus.  You notice the air above the road appears to wiggle and wave.

You can still hear the second car coming from the west.

>x road
You can't see any such thing.

* * *

>go south
You think about going south, but there is nothing of interest that way, so you decided not to move.

>go east
You think about going east, but there is nothing of interest that way, so you decided not to move.

* * *

>go west
You think about going west, but there is nothing of interest that way, so you decided not to move.

>eat grape
You reach down with your turtle mouth and eat the grape.  Yum!  You watch innocently as a Jalopy packed full of people and random stuff on its hood drives by at turtle-crunching speed.

The second car is still quite far away, you might be able to make a break for it now across the road.

>go north
Road
A long, narrow stretch of a smoothed surface.  The air above the road wobbles from the heat.  It appears to be the only thing between you and the cactus.

You can still hear the second car coming from the west, it is louder than before.  You are scared, and your instinct is to hide but you are also very hot and desperatley need that shade.

>hide
You hide in your shell because the car scares you and you feel unable to proceed further.

It then approaches you, but luckily it slows down and comes to a full stop.  The tall animal inside notices you and picks you up, placing you in the passenger seat.  You are absolutely frightened.

"Poor little turtle.  I wonder what you're doing out here?  Hmm... well, I'm off to work.  Do you want to join me?"

... You are turtle so you do not respond ...

"I'm an engineer at the military base here, you can be my company while I update the lighting in the building."

The engineer puts some snacks in front of the hole for your head and you peek out slowly.  You snatch it up as quickly as you can and then retreat back.  You like the food, so you slowly put your head back outside of your shell.  Maybe being with this tall thing that makes sounds will be beneficial.  You believe yourself to be a smart turtle.

Engineer's Workshop
A fantastic workshop filled with gadgets and doohickies.   You can see various sorts of power supplies, light sources, and wires come out of every which way.  However, you process none of this as important because you are a turtle.  Also, you remember that you're getting hungry again...  The tall animal has gone away, so you are confused.  Although... those wires look like little worms...  

You also smell something nice coming from the east.

>eat wires
*brrrsst* "Eeeek"

You didn't like the taste of those worms, it made your mouth hurt and your body tingle.  Almost immediately following that, everything goes dark and it starts to get really loud with screaming tall animals.

You start to get a little bit scared, but you still smell something really good from the east.  So that makes you forget about the darkness.

You still hear the tall animals screaming and yelling in the dark.

>go west
There is only a wall there, you see a little spider climbing up the wall.  You wish you could climb like the spider.

You still hear the tall animals screaming and yelling in the dark.

>go north
You only see a crate and a shelf full of lighting equipment, wires, power sources, and everything else an engineer might need.  No where to go over there.

You still hear the tall animals screaming and yelling in the dark.

>go east
Kitchen
A heaven to you because you are enveloped by the smells of various different types of foods.  You are extremely curious as to what each of the foods are, and if you can eat them while avoiding those other tall and loud animals.

 You can smell only a piece of bread, a carrot, and some lettuce nearby.  Your little turtle-nose is strong enough to find it if you want to eat it.

There is a large silhouette near the carrot.  

You still hear the tall animals screaming and yelling in the dark.

>eat bread
You sniff intently and finally find the bread in the dark.  It tastes really good, but you aren't quite satisfied.  It's still dark, but some emergency lights illuminate the Control Room to the east.  Your second most favorite thing besides food is shiny lights, so you are curious and want to take a look.

You still hear the tall animals screaming and yelling in the dark.
"Someone get those lights back on!!  Find the breaker!"

* * *

>go east
Kitchen
A heaven to you because you are enveloped by the smells of various different types of foods.  You are extremely curious as to what each of the foods are, and if you can eat them while avoiding those other tall and loud animals.

 You can smell only a piece of bread, a carrot, and some lettuce nearby.  Your little turtle-nose is strong enough to find it if you want to eat it.

There is a large silhouette near the carrot.  

You still hear the tall animals screaming and yelling in the dark.

>eat carrot
You sniff intently and finally find the little carrot in the dark.  It tastes good, but you aren't quite satisfied.  As soon as you finish eating it, since it's dark the chef unknowningly trips on your shell and as he's falling his cleaver is thrown out of his hands.  The cleaver slices into the heart of someone in the dark...

"Commander!!!"

The Commander is instanly killed, but you don't really notice or care about any of this since you're a turtle.

"We have a spy in our midst!!!  Find him immediately, our Commander is dead!!!"

You still hear the tall animals screaming and yelling in the dark.
"Someone get those lights back on!!  Find the breaker, and get that spy!!"

* * *

>go east
Kitchen
A heaven to you because you are enveloped by the smells of various different types of foods.  You are extremely curious as to what each of the foods are, and if you can eat them while avoiding those other tall and loud animals.

 You can smell only a piece of bread, a carrot, and some lettuce nearby.  Your little turtle-nose is strong enough to find it if you want to eat it.

There is a large silhouette near the carrot.  

You still hear the tall animals screaming and yelling in the dark.

>eat lettuce
You sniff intently and finally find the lettuce in the dark.  It tastes really good, but you aren't quite satisfied.  It's still dark, but some emergency lights illuminate the Control Room to the east.  Your second most favorite thing besides food is shiny lights, so you are curious and want to take a look.

You still hear the tall animals screaming and yelling in the dark.
"Someone get those lights back on!!  Find the breaker!!"

>eat carrot
You cannot find it now, it must have been kicked away in the midst of everyone running around in the dark.

You still hear the tall animals screaming and yelling in the dark.
"Someone get those lights back on!!  Find the breaker, and get that spy!!"

>go west
Engineer's Workshop
A fantastic workshop filled with gadgets and doohickies.    Although, you cannot really see anything so you don't care much. 

You still hear the tall animals screaming and yelling in the dark.
"Someone get those lights back on!!  Find the breaker!!"

>go east
Kitchen
 You can't smell the food from before anymore.  You still see that interesting light coming from the east though.

 

You still hear the tall animals screaming and yelling in the dark.
"Someone get those lights back on!!  Find the breaker!!"

>go east
Control Room
You can see a President Switch, an Enemy Switch, and a Missle Button on the north-wall console in front of you.  To the east is the Closet.

The buttons and switches are all out of reach... but you have an urge to reach up and try to get them anyway.  You're a turtle, you don't know any better.

Someone figures out just in time where the breaker is and gets the emergency lights on, meanwhile, the engineer fixes the wires that caused the light outage. Then the control room guard sees you...

"What, what?  What are you doing here little one?  Is that a piece of lettuce in your mouth?  Aww, well I have some extra lettuce for you up here on the console."

You are lifted onto the console with all the buttons.

>x president
It is a little green button, it looks so shiny and tasty to you.  Maybe if you just took a little nibble...

You still hear the tall animals screaming and yelling in the dark.
"Someone get those lights back on!!  Find the breaker!!"

* * *

>showme height-counter
There seems to be no such object anywhere in the model world.

>test height-counter
>--> No test scripts exist for this game.

>height-counter
That's not a verb I recognise.

* * *

>x enemy
It is a little orange button, you remember how good Oranges taste and that sort of makes you hungry again.  Maybe if you just took a little nibble...

>x missle
It is a large red button that looks a lot like a cherry, but your turtle brain cannot process that since you don't remember ever having had that sort of food before.  It does look shiny and delicious though.  Maybe if you just took a little nibble...

>x closet
You can't see any such thing.

>go east
You cannot since you are too high up and falling down would kill you.  Your little turtle instincts remind you to not walk off of tall places.

>go north
There is only a bunch of lit up screens and diodes in front of you; you cannot go anywhere...

>eat missle
"Nuclear missle armed and firing!"  You love the taste of the button, but are unsure as to why you cannot bite into it...

The odd timing of the nuclear strike causes the enemy to be caught off guard and you destroy the whole country with a barrage of missles.  The enemy is surely defeated and you saved millions of your own country's lives.

You feel disatisfied and fall asleep on the console.

    *** The End ***

Would you like to RESTART, RESTORE a saved game, QUIT or UNDO the last command?

* * *

>eat berry
You can't see any such thing.

>look
Desert
You are a turtle, and you find yourself at the edge of a road in the middle of a desert.  You hear a car coming from the east.  You do not seem too interested in other things around you but you do see a cactus across the road that might offer shade and a little berry next to your foot. Type "help" to see a list of possible commands.

>x berry
You can't see any such thing.

* * *

>eat berry
You can't see any such thing.

>showme
Desert - room
    yourself - person
        shell - open container

>x berry
You can't see any such thing.

* * *

>eat berry
You can't see any such thing.

>eat
You must supply a noun.

>go north
Road
A long, narrow stretch with a smoothed or paved surface, made for traveling by motor vehicle, carriage, etc., between two or more points; street or highway.  It appears to be the only thing between you and the cactus.  You notice the air above the road appears to wiggle and wave.

>go north
Cactus

>x shell
Your trusty shell that you use for hiding, storage, and protection.

* * *

>eat berry
You can't see any such thing.

>go nortth
You can't see any such thing.

>go north
Road
A long, narrow stretch with a smoothed or paved surface, made for traveling by motor vehicle, carriage, etc., between two or more points; street or highway.  It appears to be the only thing between you and the cactus.  You notice the air above the road appears to wiggle and wave.

>go north
stop.

>go north
You can't go that way.

>look
Cactus
A tall and spikey plant that really means nothing to you other than that it offers your sought after shade for this hot day in the desert.

* * *

>eat berry
You can't see any such thing.

>go north
Road
A long, narrow stretch with a smoothed or paved surface, made for traveling by motor vehicle, carriage, etc., between two or more points; street or highway.  It appears to be the only thing between you and the cactus.  You notice the air above the road appears to wiggle and wave.

You can still hear the second car coming from the west.

>go north
You get into the shade of the cactus which feels nice.  However, the ground under you starts to slip under your feet and you move closer to the edge of the cactus.

Control Room
"weight trigger activated .... trap activated!"

The guard looks at the camera and sees nothing but a turtle.

"dumb turtle"

The guard then resets the weight trigger and trap by pressing a button on his console.  At this point though, the turtle has already fallen through a small door where the trap was located at the cactus" trunk, but the guard takes zero notice because he has already fallen asleep.

Cactus Trap
A trap used to kill spies getting too close to the base.  The cactus was clearly fake and is actually a power unit for the trap itself.  The inside here is actually quite dull and uninteresting other than the ventilation shaft to the north.

You can see a bolt here.

* * *

>go north
Road
A long, narrow stretch with a smoothed or paved surface, made for traveling by motor vehicle, carriage, etc., between two or more points; street or highway.  It appears to be the only thing between you and the cactus.  You notice the air above the road appears to wiggle and wave.

You can still hear the second car coming from the west.

>hide
You hide in your shell because the car scares you and you feel unable to proceed further.

The car approaches you and stops.  It notices you as a poor turtle and picks you up, placing you in the passenger seat.

"Poor little turtle.  I wonder what you're doing out here?"

"Well, I'm off to work, do you want to join me?"

... You are turtle so you do not respond ...

"I'm an engineer at the military base here, you can be my company while I update the lighting in the building."

"The engineer feeds you some snacks and you feel satisfied.  Maybe being with this tall thing that makes sounds will be beneficial.  You believe yourself to be a smart turtle."

* * *

>go north
Road
A long, narrow stretch with a smoothed or paved surface, made for traveling by motor vehicle, carriage, etc., between two or more points; street or highway.  It appears to be the only thing between you and the cactus.  You notice the air above the road appears to wiggle and wave.

You can still hear the second car coming from the west.

>go north
You get into the shade of the cactus which feels nice.  However, the ground under you starts to slip under your feet and you move closer to the edge of the cactus.

The Control Room
You can see a President Switch, an Enemy Switch and a Missle Button here.

"weight trigger activated .... trap powering up!"

The guard awakens to the warning from the computer and looks at the camera but sees nothing but a turtle.

"dumb turtle..."

The guard then resets the weight trigger and trap by pressing a button on his console.  At this point though, the turtle has already fallen through a small door where the trap was located at the cactus" trunk, but the guard takes zero notice because he has already fallen back asleep.

Cactus Trap
A trap used to kill spies getting too close to the base.  The cactus was clearly fake and is actually a power unit for the trap itself.  The inside here is actually quite dull and uninteresting other than the ventilation shaft to the north.  The shaft is cut off by a grate, but the grate has since loosened, and you can see the bolts are practically hanging off.   The bolts look sort of like little lizards to you, and that makes you hungry.

>eat bolts
You eat the bolt, it's um... not so bad.  You're not sure since you're a turtle.  However, the consequence is that the grate slides down and the entrance to the Ventilation Shaft is open!  You feel an urge to go through, but you're a little bit scared.

>go norht
You can't see any such thing.

>go north
You cannot go through the grate, but unfortunately you're unable to process that information intelligently, because you're a turtle and simply run into the grate hitting your head.  You feel a small amount of pain, but you're okay.  You're also still pretty hungry, those bolts look yummy.

>showme
Cactus Trap - room
    yourself - person
        shell - open container
    bolt
    grate

>x bolts
You see nothing special about the bolt.

>x bolt
You see nothing special about the bolt.

* * *

>eat bolts
You eat the bolt, it's um... not so bad.  You're not sure since you're a turtle.  However, the consequence is that the grate slides down and the entrance to the Ventilation Shaft is open!  You feel an urge to go through, but you're a little bit scared.

>go north
Ventilation Shaft
A ventilation shaft used to cool down the trap because it can heat up easily from its power usage and being covered under sand.  It's pretty hot in here and you feel like sleeping, but you also want to move on and possibly find food.  There only seems to be one direction to go for now.

Although, the bottom of the ventilation shaft seems very weak and worn out.  It probably won't break if you only spend time on it for a few seconds.

You would have to get out of the Ventilation Shaft first.

>go north
T-Junction
The end of the main ventilation shaft, in front of you is a massive fan, likely dangerous, and to the left and right of you are further shafts but they drop downwards into unknown rooms.  The west side of the T-Junction smells like food, but the east side of the T-Junction has a bright light.

You think lights are pretty cool, because you're a turtle.  But then again, you're getting hungry and the food seems instinctively good.

>go west
You fall down the west side of the T-Junction!  Plop...  You are unhurt and a little frazzled, but you are a turtle and have no idea what just happened.  You are only concerned about the food you smell.

Kitchen
A heaven to you because you are enveloped in the smells, sounds, and sights of various different types of foods.  You are extremely curious as to what each of the foods are, and if you can eat them while avoiding those other tall and loud animals.

Upon first glance you notice a nice piece of bread near the foot of a tall and loud animal.  You also see a grape behind the counter of the tall and loud animal who makes the food.  Lastly the only other turtle-able food you see is a piece of lettuce which is curiously by the same engineer person from before.

>go east
The Control Room
You can see a President Switch, an Enemy Switch and a Missle Button here.

>eat president switch
You reach up with your tiny turtle mouth, but the console is too high for you.

* * *

>help
You are a turtle, so you can really only move, eat, and hide in your shell.  When you want to move to another area, use cardinal directions such as "go north" (or "n" ,"s", "w", "e" as shortcuts).

If you want to eat something type "eat <something>" and for this game it might not always be food as you know it.  Hiding is simply done by "hide" which could have a various number of different effects depending on the situation ("hide", "turtle", and "sleep" are all essentially the same action in this game).

Don't forget that you can still use "examine <thing>" as well to see descriptions!  The shortcut "x <thing>" works too. If you want to see the description of the current location, type "look"

>hide
That's not a verb I recognise.

>eat berry
(first taking the berry)
You reach down with your turtle mouth and eat the berry.  Yum!

>eat berry
You can't see any such thing.

* * *

>look
Desert
You are a turtle, and you find yourself at the edge of a road in the middle of a desert.  You hear a car coming from the east.  You do not seem too interested in other things around you but you do see a cactus across the road that might offer shade and a little berry next to your foot. Type "help" to see a list of possible commands.

>eat berry
You can't see any such thing.

>go east
You can't go that way.

>go west
You can't go that way.

>go south
You can't go that way.

>cross road
You can't see any such thing.

>go north
Road
A long, narrow stretch with a smoothed or paved surface, made for traveling by motor vehicle, carriage, etc., between two or more points; street or highway.  It appears to be the only thing between you and the cactus.  You notice the air above the road appears to wiggle and wave.

>go north
Cactus
A tall and spikey plant that really means nothing to you other than that it offers your sought after shade for this hot day in the desert.

* * *

>go north
CRUNCH!  You got ran over by a Jalopy carrying a ton of stuff on its hood.  Weird...  Well, you should have trusted your instincts and taken time to have a bite to eat.

    *** The End ***

Would you like to RESTART, RESTORE a saved game, QUIT or UNDO the last command?

>restart
Nuclear war is on the horizon, two nations are in extremely high tension and anything can set the other one off to fire first.  There are rumors about talks of peace, but it seems unlikely at this point.  Each side is hoping that some how nuclear war can be prevented to save the millions of lives that it would cause...

Turtle of Wrath
An Interactive Fiction by Alex Ayerdi
Release 1 / Serial number 150418 / Inform 7 build 6L38 (I6/v6.33 lib 6/12N) SD

Desert
You are a turtle, and you find yourself at the south edge of a road in the middle of a desert.  You hear a car coming from the east, and another coming from the west much farther away.

You do not seem too interested in other things around you but you do see a cactus across the road that might offer shade and you see a little grape next to your foot. Type "help" to see a list of possible commands.

>eat grape
You reach down with your turtle mouth and eat the grape.  Yum!  You watch innocently as a Jalopy packed full of people and random stuff on its hood drives by at turtle-crunching speed.

>go north
Road
A long, narrow stretch with a smoothed or paved surface, made for traveling by motor vehicle, carriage, etc., between two or more points; street or highway.  It appears to be the only thing between you and the cactus.  You notice the air above the road appears to wiggle and wave.

You can still hear the second car coming from the west.  You are scared, and your instinct is to hide but you are also very hot and desperatley need that shade.

>go north
You get into the shade of the cactus which feels nice.  However, the ground under you starts to slip under your feet and you move closer to the edge of the cactus.

Control Room
You can see a President Switch, an Enemy Switch, and a Missle Button here.  To the east is the Closet.

"weight trigger activated .... trap powering up!"

The guard awakens to the warning from the computer and looks at the camera but sees nothing but a turtle.

"dumb turtle..."

The guard then resets the weight trigger and trap by pressing a button on his console.  At this point though, the turtle has already fallen through a small door where the trap was located at the cactus trunk, but the guard takes zero notice because he has already fallen back asleep.

Cactus Trap
A trap used to kill spies getting too close to the base.  The cactus was clearly fake and is actually a power unit for the trap itself.  The inside here is actually quite dull and uninteresting other than the ventilation shaft to the north.  The shaft is cut off by a grate, but the grate has since loosened, and you can see the bolts are practically hanging off.

The bolts look sort of like little lizards to you, and that makes you hungry.

>go north
You cannot go through the grate, but unfortunately you're unable to process that information intelligently because you're a turtle and simply run into the grate hitting your head.  You feel a small amount of pain, but you're okay.  You're also still pretty hungry; those bolts look tasty.

>x bolts
The little lizard-looking bolts are quite old by now, they are barely holding the grate on the Ventilation Shaft in front of you.

>x cactus
You can't see any such thing.

>x cactus trap
You can't see any such thing.

>look
Cactus Trap
A trap used to kill spies getting too close to the base.  The cactus was clearly fake and is actually a power unit for the trap itself.  The inside here is actually quite dull and uninteresting other than the ventilation shaft to the north.  The shaft is cut off by a grate, but the grate has since loosened, and you can see the bolts are practically hanging off.

The bolts look sort of like little lizards to you, and that makes you hungry.

>eat bolts
You eat the bolts, they're um... not so bad.  You're not sure since you're a turtle.  However, the grate slides down and the entrance to the Ventilation Shaft is open!  You feel an urge to go through, but you're a little bit scared.  It seems to stretch on forever, dimly lit, and there is a steady flow of air rushing towards you.

>go north
Ventilation Shaft
A ventilation shaft used to cool down the trap because it can heat up easily from its power usage and being covered under sand.  It's pretty hot in here and you feel like sleeping, but you also want to move on and possibly find food.  There only seems to be one direction to go for now.

Although the bottom of the ventilation shaft seems very weak and worn out, it probably won't break if you only spend time on it for a few seconds.

>go north
T-Junction
The end of the main ventilation shaft, in front of you is a massive fan, likely dangerous, and to the left and right of you are further shafts but they drop downwards into unknown rooms.  The west side of the T-Junction smells like food, but the east side of the T-Junction has a bright light.

You think lights are pretty cool, because you're a turtle.  But then again, you're getting hungry and the food seems instinctively good.

>go north
You were oddly enticed to go into the fast moving blade at the T-Junction.  As soon as you touch the blade you are swep into it and are completely ripped apart to shreds.  You live...just kidding, you died a very swift death.

    *** The End ***

Would you like to RESTART, RESTORE a saved game, QUIT or UNDO the last command?

>restart
Nuclear war is on the horizon, two nations are in extremely high tension and anything can set the other one off to fire first.  There are rumors about talks of peace, but it seems unlikely at this point.  Each side is hoping that some how nuclear war can be prevented to save the millions of lives that it would cause...

Turtle of Wrath
An Interactive Fiction by Alex Ayerdi
Release 1 / Serial number 150418 / Inform 7 build 6L38 (I6/v6.33 lib 6/12N) SD

Desert
You are a turtle, and you find yourself at the south edge of a road in the middle of a desert.  You hear a car coming from the east, and another coming from the west much farther away.

You do not seem too interested in other things around you but you do see a cactus across the road that might offer shade and you see a little grape next to your foot. Type "help" to see a list of possible commands.

* * *

>go north
You were oddly enticed to go into the fast moving blade at the T-Junction.  As soon as you touch the blade you are swep into it and are completely ripped apart to shreds.  You live...just kidding, you died a very swift death.

    *** The End ***

Would you like to RESTART, RESTORE a saved game, QUIT or UNDO the last command?

>undo
T-Junction
[Previous turn undone.]

* * *

>go north
Ventilation Shaft
A ventilation shaft used to cool down the trap because it can heat up easily from its power usage and being covered under sand.  It's pretty hot in here and you feel like sleeping, but you also want to move on and possibly find food.  There only seems to be one direction to go for now.

Although the bottom of the ventilation shaft seems very weak and worn out, it probably won't break if you only spend time on it for a few seconds.

>go west
You can't go that way.

* * *

>eat grape
You reach down with your turtle mouth and eat the grape.  Yum!  You watch innocently as a Jalopy packed full of people and random stuff on its hood drives by at turtle-crunching speed.

* * *

>go north
Road
A long, narrow stretch with a smoothed or paved surface, made for traveling by motor vehicle, carriage, etc., between two or more points; street or highway.  It appears to be the only thing between you and the cactus.  You notice the air above the road appears to wiggle and wave.

You can still hear the second car coming from the west.

>go north
You get into the shade of the cactus which feels nice.  However, the ground under you starts to slip under your feet and you move closer to the edge of the cactus.

The Control Room
You can see a President Switch, an Enemy Switch and a Missle Button here.

"weight trigger activated .... trap powering up!"

The guard awakens to the warning from the computer and looks at the camera but sees nothing but a turtle.

"dumb turtle..."

The guard then resets the weight trigger and trap by pressing a button on his console.  At this point though, the turtle has already fallen through a small door where the trap was located at the cactus" trunk, but the guard takes zero notice because he has already fallen back asleep.

Cactus Trap
A trap used to kill spies getting too close to the base.  The cactus was clearly fake and is actually a power unit for the trap itself.  The inside here is actually quite dull and uninteresting other than the ventilation shaft to the north.  The shaft is cut off by a grate, but the grate has since loosened, and you can see the bolts are practically hanging off.

The bolts look sort of like little lizards to you, and that makes you hungry.

>go north
You cannot go through the grate, but unfortunately you're unable to process that information intelligently, because you're a turtle and simply run into the grate hitting your head.  You feel a small amount of pain, but you're okay.  You're also still pretty hungry, those bolts look yummy.

>go west
For some reason you try to go west inside of the Cactus Trap, but you hit your tiny little head against the wall.  Unfortunately, your dreams of being a ninja turtle have not come true at this moment and you do not scale the wall.

>eat grate
That's plainly inedible.

>eat cactus trap
You can't see any such thing.

>look
Cactus Trap
A trap used to kill spies getting too close to the base.  The cactus was clearly fake and is actually a power unit for the trap itself.  The inside here is actually quite dull and uninteresting other than the ventilation shaft to the north.  The shaft is cut off by a grate, but the grate has since loosened, and you can see the bolts are practically hanging off.

The bolts look sort of like little lizards to you, and that makes you hungry.

>eat bolts
You eat the bolt, it's um... not so bad.  You're not sure since you're a turtle.  However, the consequence is that the grate slides down and the entrance to the Ventilation Shaft is open!  You feel an urge to go through, but you're a little bit scared.

>go north
Ventilation Shaft
A ventilation shaft used to cool down the trap because it can heat up easily from its power usage and being covered under sand.  It's pretty hot in here and you feel like sleeping, but you also want to move on and possibly find food.  There only seems to be one direction to go for now.

Although, the bottom of the ventilation shaft seems very weak and worn out.  It probably won't break if you only spend time on it for a few seconds.

>hide
The continuous weight of you just sitting there sleeping causes the weak under part of the ventilation shaft to screech and break underneath you!  You feel your little turtle-stomach flip over a few times before you hit the ground with your shell.

You seem to have landed in some sort of dark room.

Closet
The closet is a dark place and it has mops, buckets, various cleaning equipment, and tools.  These are of no interest to you because you are a turtle.  You are however interested in getting out, the door seems to be cracked open enough for you to escape.  On the other hand, you are still pretty sleepy from not eating in a while and from the hot air.

>showme hiding-counter
There seems to be no such object anywhere in the model world.

>showme grape
grape - thing
location: in the Desert
singular-named, improper-named; unlit, edible, portable; eaten
list grouping key: none
printed name: "grape"
printed plural name: none
indefinite article: none
description: "A little red grape that looks like it was recently picked, perhaps arriving here after falling off of a truck."
initial appearance: none

>go west
"Hmm, what was that...  I thought I heard something.  Eh, probably nothing, I have been eating way too many of those tacos...  It must be making me hallucinate now."

You sneak past the control room guard, but you don't actually realize you're doing this...  
The Control Room
You can see a President Switch, an Enemy Switch and a Missle Button here.

You can smell something good from the west.

>go west
Kitchen
A heaven to you because you are enveloped in the smells, sounds, and sights of various different types of foods.  You are extremely curious as to what each of the foods are, and if you can eat them while avoiding those other tall and loud animals.

 Upon first glance you notice a nice piece of bread near the foot of a tall and loud animal.  You also see a carrot behind the counter of the tall and loud animal who makes the food.  Lastly the only other turtle-able food you see is a piece of lettuce which is curiously by the same engineer person from before.

>go east
The Control Room
You can see a President Switch, an Enemy Switch and a Missle Button here.